1111111111
1P000000C1
1C0C0000E1
1111111111