1111111111
1P000000C1
1C0C0110E1
100C0110C1
1000000001
1111111111