1111111111
1P0000C0E1
1C01111001
10001000C1
10C0000001
1111111111
