111111111111
1P0000010001
101111101C01
10C000000001
111011111101
1C0000C000E1
100011101001
111111111111
