11111111111111
1P0000000000C1
11101110111001
1C0010010000E1
10011100101101
1C0000C0000001
11111111111111